5,24,24,24,24,24,24,24,24,24,24,32,
36,63,35,79,35,62,63,35,79,35,62,37,
36,37,53,20,53,36,37,53,20,53,36,37,
36,81,9,15,53,36,37,53,14,9,80,37,
36,37,53,53,53,36,37,53,53,53,36,37,
36,52,24,24,24,51,52,24,24,24,51,37,
36,63,35,35,35,62,63,35,35,35,62,37,
36,37,53,53,53,36,37,53,53,53,36,37,
36,81,9,4,53,36,37,53,3,9,80,37,
36,37,53,20,53,36,37,53,20,53,36,37,
36,52,24,68,24,51,52,24,68,24,51,37,
42,35,35,35,35,35,35,35,35,35,35,17
