4,23,23,23,23,23,23,23,23,23,23,31
35,62,34,78,34,61,62,34,78,34,61,36
35,36,52,19,52,35,36,52,19,52,35,36
35,80,8,14,52,35,36,52,13,8,79,36
35,36,52,52,52,35,36,52,52,52,35,36
35,51,23,23,23,50,51,23,23,23,50,36
35,62,34,34,34,61,62,34,34,34,61,36
35,36,52,52,52,35,36,52,52,52,35,36
35,80,8,3,52,35,36,52,2,8,79,36
35,36,52,19,52,35,36,52,19,52,35,36
35,51,23,67,23,50,51,23,67,23,50,36
41,34,34,34,34,34,34,34,34,34,34,16
